................................
................................
................................
................................
................................
........##......................
........#############...........
...........##########...........
...........##########...........
...........#############........
......................##........
................................
................................
................................
................................
................................
................................
................................
