00000000000000000000000000000000
00000000000000000000000000000000
00000000000000000000000000000000
00000000000000000000000000000000
00000000000000000000000000000000
00000000001111111111110000000000
00000000001111111111110000000000
00000000001111111111110000000000
00000000111111111111111100000000
00000000111111111111111100000000
00000000001111111111110000000000
00000000001111111111110000000000
00000000001111111111110000000000
00000000000000000000000000000000
00000000000000000000000000000000
00000000000000000000000000000000
00000000000000000000000000000000
00000000000000000000000000000000
