................................
................................
................................
................................
................................
..........############..........
..........############..........
..........############..........
........################........
........################........
..........############..........
..........############..........
..........############..........
................................
................................
................................
................................
................................
